very - très
quite - assez
nonetheless - néanmoins
however - cependant
because of that - à cause de cela
thanks to - grâce à
for example - par exemple
more than - plus que
less than - moins que
better than - mieux que
worse than - pire que
the most... - le/la/les plus...
the least... - le/la/les moins...
the best - le meilleur
the worst - le pire
what I like most is - ce que j'aime le plus c'est
what I like least is - Ce que j'aime le moins, c'est
firstly - d'abord
finally - finalement
never - ne...jamais
no longer - ne...plus
neither...nor - ni...ni
nothing / anything - ne...rien
only - ne...que
I'm interested in - je m'intéresse à
it's exciting - c'est passionnant
it's hilarious - c'est hilarant
It's enriching - c'est enrichissant
it's tiring - c'est fatigant
it's annoying - c'est pénible
I find it fascinating - je trouve ça fascinant
captivating - captivant
useless - inutile
boring - barbant
complicated - compliqué
last year - l'année dernière
two years ago - il y a deux ans
when I was little - quand j'étais petit(e),...
usually - d'habitude
next year - l'année prochaine
in two years' time - dans deux ans
I used to go - j'allais
I used to be - j'étais
I used to have - j'avais
I used to do - je faisais
I used to visit - je visitais
What a pity! - Quel dommage!
That's crazy! - C'est fou!
This is shameful! - C'est une honte!
How lucky! - Quelle chance!
How awful! - Quelle horreur!
It's too good! - C'est trop bien!
the weather is awful - il fait un temps de chien
it's raining cats and dogs - il pleut des cordes
it's far-fetched - c'est tiré par les cheveux
it's nothing special / it's a bit meh - ça ne casse pas trois pattes à un canard
it gets on my nerves - ça me casse les pieds